XXXXXXXXXXXXXXXXXXXXXXXXXXXXXXXXXXXXXXXXXXXXXXXXXX
XWWWWWWWWWWWWWWWWWWWWWWWWWWWWWWWWWWWWWWWWWWWWWWWWX
XWCXXXXXXXXXMXXXXXXXXXCWXXWXXXXXXCXXXXXXXWXXWXPXWX
XWXOXOXOXOXOXOXOXOXOXOXWXXWXXXXXXMXXXXXXXWMXXXXXWX
XWXOXOXOXOXOXOXOXOXOXOXWXXWXOOOOOOOOOOOOXXXXWWWWWX
XWXXXXXMXWWWWWWWXMXXXXXWXXWXXXXXXXXXXXXOOWXXXXXXWX
XWXXXXXXXWXXKXXWXXXXXXXWXXWOOOOOOOOOOOXMXWXXXMXXWX
XWXXXXXXXWCXXXCWXXXXXXXWXXWCXXXXXXXXXXXXXWWWWWWWWX
XWXMXXXXXWWWXWWWXXXXXMXWXXWXXXXXXXOOOOOOOCXXXXXXWX
XWXOXOXOXOXOXOXOXOXOXOXWXXWWWWWWWXOXXXXXXOOOOOOXWX
XWXOXOXOXOXOXOXOXOXOXOXWXXWXXKXXWXOXXXMXXXXXXXXXWX
XWCXXXXXXXXXMXXXXXXXXXCWXXWCXXXCXXXXOOOOOOOOOOXCWX
XWXWWWWWWWWWWWWWWWWWWWWWXXWWWWWWWWWWWWWWWWWWWWXWWX
XWXXXXXXXXXXXXXXXXXXXXXX2XXXXXXXXXXXXXXXXXXXXXXXWX
XW0XWWWWWWWWWWWWWWWWWWWXXXXWWWWWWWWWWWWWWWWWWWX1WX
XWXXXXXXXXXXXXXXXXXXXXXXX3XXXXXXXXXXXXXXXXXXXXXXWX
XWWWWWWWWWXWWWWWWWWWWWWWXXWWWWWWWWWWWWWWWWWXWWWWWX
XWCXXXXXOOXOCXXXXXXXXXCWXXWXXKXXWXOCOXOCOXOXOCOCWX
XWWWWLWXOOXOXOOOOOOOOOXWXXWCXXXCWXOXOXOXOXOXOXOXWX
XWMXXXWXXXXOXXOCXXXXCOXWXXWWWXWWWXOXOXOXOXOXOXOXWX
XWGGGXWXOOOOOXOCXXMXCOXWXXWXXXXXXXXXXXXXXXOXXXXXWX
XWGRGXWXOXXXOXOXOOOOOOXWXXWXXXXOXOOOOOOOOOOXOOOXWX
XWGGGMWXXXOXXXOXXXXXXXKWXXWMXXXOXXXXXXXXXXXXXXXMWX
XWWWWWWWWWWWWWWWWWWWWWWWWWWWWWWWWWWWWWWWWWWWWWWWWX
XXXXXXXXXXXXXXXXXXXXXXXXXXXXXXXXXXXXXXXXXXXXXXXXXX