XXXXXXXXXXXXXXXXXXXXXXXXXXXXXXXXXXXXXXXXXXXXXXXXXX
XWWWWWWWWWWWWWWWWWWWWWWWWWWWWWWWWWWWWWWWWWWWWWWWWX
XWCOXOXOXOXOXOKOXOXOXOXOXOXOXOXOKOXOXOXOXOXOWXPXWX
XWXXXXXXXXXXXXXXXXXXXXXXXXXXXXXXXXXXXXXXXXXXXXXXWX
XWXOXOXOXOXOXOXOXOXOXOXOXOXOXOXOXOXOXOXOXOXOWWWWWX
XWXXXXXXXXXXXXXXXXXXXXXXXXXXXXXXXXXXXXXXXXXXXXXXWX
XWKOMOXOXOXOMOXOXOXOMOXOXOXOMOXOXOXOMOXOXOXOMOKOWX
XWXOXOMOXOMOXOMOXOMOXOMOXOMOXOMOXOMOXOMOXOMOXOXOWX
XWCOXOXOMOXOXOXOMOXOXOXOMOXOXOXOMOXOXOXOMOXOXOCOWX
XWWWWWWWWWWWWWWWWWWWWWWWXWWWWWWWWWWWWWWWWWWWWWWWWX
XWKXXXXXXXXXXXXXXXXXXXXX2XXXXXXXXXXXXXXXXXXXXXXKWX
XW0OOOOOOOOOOOOOOOOOOOOOOOOOOOOOOOOOOOOOOOOOOOO1WX
XWKXXXXXXXXXXXXXXXXXXXXX3XXXXXXXXXXXXXXXXXXXXXXKWX
XWWWWWWWWWWWWWWWWWWWWWWWXWWWWWWWWWWWWWWWWWWWWWWWWX
XWMOXOXOXOMOXOXOXOMOXOXOXOXOXOMOXOXOXOMOXOXOXOMOWX
XWXOMOXOMOXOMOXOMOXOMOXOXOXOMOXOMOXOMOXOMOXOMOXOWX
XWXOXOMOXOXOXOMOXOXOXOMOXOMOXOXOXOMOXOXOXOMOXOXOWX
XWXXXXXXXXXXXXXXXXXXXXXXXXXXXXXXXXXXXXXXXXXXXXXXWX
XWWWWLWOXOMOKOXOXOXOXOXOXOXOXOMOXOKOXOXOXOXOXOXOWX
XWXXXXWOXOXOMOXOXOXOXOXOXOCOMOXOMOXOXOXOXOXOXOXOWX
XWGGGXWOXOXOXOMOXOXOXOXOMOXOXOXOXOMOXOXOXOXOMOXOWX
XWGRGXWOCOXOXOXOXOMOXOMOXOXOXOXOXOXOMOXOXOMOXOCOWX
XWGGGXWOXOXOXOXOKOXOMOXOXOXOXOXOXOXOXOKOMOXOXOXOWX
XWWWWWWWWWWWWWWWWWWWWWWWWWWWWWWWWWWWWWWWWWWWWWWWWX
XXXXXXXXXXXXXXXXXXXXXXXXXXXXXXXXXXXXXXXXXXXXXXXXXX