XXXXXXXXXXXXXXXXXXXXXXXXXXXXXXXXXXXXXXXXXXXXXXXXXX
XWWWWWWWWWWWWWWWWWWWWWWWWWWWWWWWWWWWWWWWWWWWWWWWWX
XWXXXXXXXXXXXXXXXXXXXXXXXXXXXXXXXXXXXXXXXXXXWXPXWX
XWXOOOOOOOOOOOOOOOOOOOOOOOOOOOOOOOOOOOOOOOOXXXXXWX
XWXOKXMXXXMXXXMXXXMXXXMXXXMXXXMXXXMXXXMKXXOOWWWWWX
XWXOMXXXMXXXMXXXMXXXMXCXMXXXMXXXMXXXMXXXMXXXXXXXWX
XWXOOOOOOOOOOOOOOOOOOOOOOOOOOOOOOOOOOOOOOOOOOOOXWX
XWXXXXXXXXXXXXXXXXXXXXXXXXXXXXXXXXXXXXXXXXXXXXXXWX
XWWWWWWWWWWWWWWWWWWWWWWWWWWWWWWWWWWWWWWWWWWWWWWXWX
XWXXXOOOOOOOOOOOOOOXXXXXXXXXXXXXOOOOOOOOOOOOOOOXWX
XWXOKXXXXXXXXXXXXXXCWWWWWXWWWWWCXXXXXXXXXXXXXKOXWX
XWXOMOOOOOOOOOOOOOOOWX0XXXXX1XWOOOOOOOOOOOOOOMOXWX
XWXOKXXXXXXXXXXXXXXKWX2XXXXX3XWKXXXXXXXXXXXXXKOXWX
XWXOOOOOOOOOOOOOOOOXWWWWWXWWWWWXOOOOOOOOOOOOOOOXWX
XWXXXXXXXXXXXXXXXXXXXXXXXXXXXXXXXXXXXXXXXXXXXXXXWX
XWXWWWWWWWWWWWWWWWWWWWWWWWWWWWWWWWWWWWWWWWWWWWWWWX
XWXOOOOXXXXXXXXXXXXXXXXXXXXXXXXXXXXXXXXXXXXXXXXXWX
XWXXXXXXWXOOOOOOOOOOOOOOOOOOOOOOOOOOOOOOOOOOOOOXWX
XWWWWLWWWXOKXXXXXMXXXXXXXXXCXXXXXXXXXMXXXXXXXKOXWX
XWXXXXWXMXOXXXXMXXXXKXXXXXXMXXXXXXKXXXXXMXXXXXOXWX
XWGGGXWXOOOKXXXMXXXXXXXXXXXCXXXXXXXXXXMXXXXXXKOXWX
XWGRGXWXOOOOOOOOOOOOOOOOOOOXOOOOOOOOOOOOOOOOOOOXWX
XWGGGXWXXXXXXXXXXXXXXXXXXXXXXXXXXXXXXXXXXXXXXXXXWX
XWWWWWWWWWWWWWWWWWWWWWWWWWWWWWWWWWWWWWWWWWWWWWWWWX
XXXXXXXXXXXXXXXXXXXXXXXXXXXXXXXXXXXXXXXXXXXXXXXXXX